111111111111111
1C001110000C001
101001000111101
1C10000101C0001
101C00010111EC1
10100C01P0C1C01
111111111111111
