11111111111111111111111111
1000000001000000000N0N00C1
10000000010000000000011111
1000100100000000C000000001
10100000101110000001111001
10000N0001000000N000000011
1001000C0000000C0000000001
101001000100000111100N0001
10100000010000000010000001
10000N0000000000C001110001
100110000100000000000E0001
10000100010000001111000001
1000000C0011110C000000P001
11111111111111111111111111
