111111111111111
1P0000000N000E1
100000010000001
1000000C1000001
10000000000N001
10000N000000001
111111111111111
