1111111111111111111111
1C001110000C0000C000N1
1010N1000111101110N011
1C10000101C0001C001111
101CN0010111EC10011111
10100C01P0C1C0100000C1
1111111111111111011111
100001C0000111C0000001
11010N00N000000N000101
11C11111000C0011011011
1111111111111111111111
