111111111111111
1C0000P0000C0E1
111111111111111
