1111111111
1P00000001
10000C0111
10N00001E1
1111111111